Consulting at relation: wn_at.pl
Consulting cs relation: wn_cs.pl
Consulting ent relation: wn_ent.pl
Consulting hyp relation: wn_hyp.pl
Consulting ins relation: wn_ins.pl
Consulting mm relation: wn_mm.pl
Consulting mp relation: wn_mp.pl
Consulting ms relation: wn_ms.pl
Consulting sim relation: wn_sim.pl
car =: [auto,automobile,cable car,car,elevator car,gondola,machine,motorcar,railcar,railroad car,railway car]
car hyp: [automotive vehicle,compartment,motor vehicle,wheeled vehicle]
car inverse hyp: [Model T,S.U.V.,SUV,Stanley Steamer,ambulance,baggage car,beach waggon,beach wagon,bus,cab,cabin car,caboose,carriage,club car,coach,compact,compact car,convertible,coupe,cruiser,electric,electric automobile,electric car,estate car,freight car,gas guzzler,guard's van,hack,handcar,hardtop,hatchback,heap,horseless carriage,hot rod,hot-rod,jalopy,jeep,landrover,limo,limousine,loaner,lounge car,luggage van,mail car,minicar,minivan,pace car,passenger car,patrol car,phaeton,police car,police cruiser,prowl car,race car,racer,racing car,roadster,runabout,saloon,secondhand car,sedan,slip carriage,slip coach,sport car,sport utility,sport utility vehicle,sports car,squad car,station waggon,station wagon,stock car,subcompact,subcompact car,taxi,taxicab,tender,tourer,touring car,two-seater,used-car,van,waggon,wagon]
car mm: [railroad train,train]
car mp: [airship,cable railway,dirigible,elevator,funicular,funicular railway,lift]
car inverse mp: [accelerator,accelerator pedal,air bag,anti-sway bar,auto accessory,automobile engine,automobile horn,automobile trunk,bonnet,buffer,bumper,car door,car horn,car mirror,car seat,car window,cowl,cowling,fender,fin,first,first gear,floorboard,gas,gas pedal,gasoline engine,glove compartment,grille,gun,high,high gear,hood,hooter,horn,low,low gear,luggage compartment,motor horn,petrol engine,radiator grille,rear window,reverse,reverse gear,roof,running board,stabilizer bar,sunroof,sunshine-roof,suspension,suspension system,tail fin,tailfin,third,third gear,throttle,trunk,window,wing]
tree =: [corner,shoetree,tree,tree diagram]
tree hyp: [channelise,channelize,chase,chase after,direct,dog,elongate,give chase,go after,guide,head,ligneous plant,maneuver,manoeuver,manoeuvre,plane figure,plant,point,set,steer,stretch,tag,tail,track,trail,two-dimensional figure,woody plant]
tree inverse hyp: [Acrocarpus fraxinifolius,Adenanthera pavonina,Aegiceras majus,African sandalwood,African walnut,Alstonia scholaris,American olive,Andaman marble,Australian nettle,Australian nettle tree,Avicennia officinalis,Azadirachta indica,Baphia nitida,Barbados pride,Bombax ceiba,Bombax malabarica,Brachystegia speciformis,Brazilian pepper tree,Brisbane quandong,Brya ebenus,Burma padauk,Burmese rosewood,Butea frondosa,Butea monosperma,Caesalpinia bonduc,Caesalpinia bonducella,Caesalpinia coriaria,Caesalpinia echinata,Caesalpinia ferrea,Calocarpum zapota,Calophyllum calaba,Calophyllum candidissimum,Calophyllum longifolium,Calycophyllum candidissimum,Caryocar nuciferum,Castanea chrysophylla,Castanopsis chrysophylla,Ceratopetalum gummiferum,Cercidium floridum,Ceylon gooseberry,China tree,Chinese parasol,Chinese parasol tree,Chinese scholar tree,Chinese scholartree,Chloroxylon swietenia,Christmas bush,Christmas tree,Chrysolepis chrysophylla,Clusia flava,Conocarpus erectus,Cordia gerascanthus,Cordyline australis,Crescentia cujete,Dalbergia cearensis,Dalbergia retusa,Dalbergia sissoo,Diospyros ebenum,Diospyros kurzii,Dovyalis hebecarpa,Drimys winteri,Elaeocarpus grandis,Enterolobium cyclocarpa,Eucarya acuminata,Firmiana simplex,Fusanus acuminatus,Guinea pepper,Gymnocladus dioica,Hoheria populnea,Holarrhena antidysenterica,Holarrhena pubescens,Hydnocarpus kurzii,Hydnocarpus laurifolia,Hydnocarpus wightiana,Idesia polycarpa,Indian beech,Inga edulis,Inga laurina,Jamaica bayberry,Jamaica dogwood,Jamaican cherry,Japanese pagoda tree,Japanese varnish tree,Kentucky coffee tree,Kirkia wilmsii,Laguncularia racemosa,Lansium domesticum,Leucadendron argenteum,Leucaena glauca,Leucaena leucocephala,Lithocarpus densiflorus,Lovoa klaineana,Lysiloma bahamensis,Lysiloma latisiliqua,Manilkara bidentata,Maria,Melia Azadirachta,Melia azedarach,Melia azederach,Meryta sinclairii,Mesua ferrea,Montezuma,Muntingia calabura,Myroxylon balsamum,Myroxylon balsamum pereirae,Myroxylon pereirae,Myroxylon toluiferum,Nauclea diderrichii,Orites excelsa,Osmanthus americanus,Oxandra lanceolata,Palaquium gutta,Parkinsonia florida,Persian lilac,Peruvian balsam,Peruvian mastic tree,Phellodendron amurense,Pimenta acris,Piscidia erythrina,Piscidia piscipula,Pisonia aculeata,Pithecellobium dulce,Plagianthus betulinus,Plagianthus regius,Pomaderris apetala,Poncirus trifoliata,Pongamia glabra,Pouteria zapota,Pseudobombax ellipticum,Psychotria capensis,Pterocarpus angolensis,Pterocarpus indicus,Pterocarpus macrocarpus,Pterocarpus marsupium,Pterocarpus santalinus,Pterospermum acerifolium,Ruptiliocarpon caracolito,Sabinea carinalis,Santa Maria tree,Santalum album,Sarcocephalus diderrichii,Schinus chichita,Schinus molle,Schinus terebinthifolius,Sesbania grandiflora,Sloanea jamaicensis,Sophora japonica,Sophora secundiflora,Sophora sinensis,Sophora tetraptera,Spanish elm,Spanish tamarind,Stenocarpus salignus,Stenocarpus sinuatus,Taraktagenos kurzii,Taraktogenos kurzii,Tarrietia argyrodendron,Tectona grandis,Triplochiton scleroxcylon,Vangueria infausta,Vangueria madagascariensis,Virgilia capensis,Virgilia divaricata,Virgilia oroboides,Xylopia aethiopica,aalii,acacia,albizia,albizzia,alder,alder tree,amboyna,andelmin,angelim,angiospermous tree,anise tree,arbor,arere,arishth,aroeira blanca,ash,ash tree,azedarach,azederach,balata,balata tree,basswood,bay-rum tree,bayberry,bean tree,beech,beech tree,beefwood,birch,birch tree,bitterwood tree,black mangrove,blackwood,blackwood tree,bloodwood tree,blue fig,bonduc,bonduc tree,bonsai,bottle tree,bottle-tree,brazilian ironwood,brazilwood,break-axe,breakax,breakaxe,bully tree,button mangrove,button tree,cabbage tree,calaba,calabash,calabash tree,calabur tree,calabura,camachile,camwood,caracolito,carib wood,cassia,casuarina,chaulmoogra,chaulmoogra tree,chaulmugra,chestnut,chestnut tree,chicot,chinaberry,chinaberry tree,chinchona,cinchona,cladogram,clusia,cockspur,cocobolo,coffee,coffee tree,conacaste,conessi,coral bean,coral tree,coral-wood,coralwood,cork tree,dagame,dak,devil tree,devilwood,dhak,dhava,dhawa,dipterocarp,dita,dita bark,divi-divi,ebony,ebony tree,elephant's ear,elm,elm tree,erythrina,evergreen beech,fever tree,fig tree,firewheel tree,fish fuddle,flowering tree,frijolillo,frijolito,fringe tree,giant chinkapin,gliricidia,golden chinkapin,granadilla tree,granadillo,grass tree,guama,gum,gum tree,gutta-percha tree,gymnospermous tree,hackberry,hazel,hazel tree,hop hornbeam,hornbeam,houhere,huamachil,ice-cream bean,idesia,incense tree,inga,ironwood,ironwood tree,ivory tree,ketembilla,ketembilla tree,keurboom,kiaat,kingwood,kingwood tree,kino,kitambilla,kitembilla,kowhai,kurchee,kurchi,lacebark,lancewood,lancewood tree,langsat,langset,lanseh tree,laurelwood,lead tree,lemon-wood,lemon-wood tree,lemonwood,lemonwood tree,lepidobotrys,lime,lime tree,linden,linden tree,locust,locust tree,mahogany,mahogany tree,mammee,manila tamarind,maple-leaved bayur,marble-wood,marblewood,margosa,marmalade tree,mayeng,medlar,mescal bean,millettia,molle,msasa,nakedwood,necklace tree,neem,neem tree,negro pepper,nettle tree,nim tree,nitta tree,oak,oak chestnut,oak tree,obeche,obechi,opepe,padauk,padouk,palas,palm,palm tree,palo verde,pandanus,peach-wood,peachwood,peacock flower fence,pepper tree,pernambuco wood,phoenix tree,plane tree,platan,pollard,poon,prickly ash,pride of Bolivia,pride-of-India,princewood,puka,quandang,quandong,quandong tree,quira,red sandalwood,red sanders,red sanderswood,red saunders,red silk-cotton tree,ribbon tree,ribbonwood,rose chestnut,rosewood,rosewood tree,samba,sandalwood tree,sapling,sapote,satinwood,satinwood tree,scarlet wisteria tree,screw pine,scrub beefwood,shade tree,shaving-brush tree,shingle tree,silk wood,silkwood,silver ash,silver quandong tree,silver tree,simal,sisham,sissoo,sissu,snag,soapberry,soapberry tree,souari,souari nut,souari tree,southern beech,stemma,sycamore,tanbark oak,teak,timber tree,tipu,tipu tree,tolu balsam tree,tolu tree,tree of knowledge,treelet,trifoliata,trifoliate orange,true sandalwood,tulipwood tree,turreae,vegetable hummingbird,wheel tree,white mangrove,white popinac,wild cinnamon,wild fig,wild medlar,wild medlar tree,wild orange,wild tamarind,willow,willow tree,winter's bark,winter's bark tree,yellow jacaranda,yellowwood,yellowwood tree,zebrawood,zebrawood tree]
tree mm: [forest,wood,woods]
guitar =: [guitar]
guitar hyp: [stringed instrument]
guitar inverse hyp: [Hawaiian guitar,acoustic guitar,bass guitar,cither,cithern,citole,cittern,electric guitar,gittern,steel guitar,uke,ukulele]
Lennon =: [John Lennon,Lennon]
Lennon ins: [ballad maker,rock star,songster,songwriter]
Lennon mm: [Beatles]
London =: [British capital,Greater London,Jack London,John Griffith Chaney,London,capital of the United Kingdom]
London ins: [author,national capital,writer]
London mp: [England]
London inverse mp: [Big Ben,Bloomsbury,City of London,City of Westminster,Fleet Street,Greenwich,Harley Street,Lombard Street,Newgate,Old Bailey,Pall Mall,Soho,Tower of London,Trafalgar Square,Wembley,West End,Westminster,Whitehall,Wimbledon,the City]
Shakespeare =: [Bard of Avon,Shakespeare,Shakspere,William Shakespeare,William Shakspere]
Shakespeare ins: [dramatist,playwright,poet]
